6,7,
1,1,1,1,1,1,
1,10,2,2,4,1,
1,16,2,2,6,1,
1,7,8,9,3,1,
1,11,12,14,13,1,
1,15,0,0,5,1,
1,1,-1,-1,1,1,
